5 10
NNCCCCCNNN
NNNCCCNNNN
NNCSCCCCCN
NCCCCCCCNN
NNNNNNNNNN
